26
15
1 1 2 2 1 1 1 1 2 1 1 1 1 3 1 1 1 1 2 1 1 1 3 1 1 1
3 4 4 4 4 6 1 4 4 4 4 4 4 4 4 4 4 4 4 4 4 4 8 4 4 1
1 4 4 4 4 4 1 6 4 8 4 4 4 4 4 4 4 4 4 4 6 4 4 5 4 1
1 4 4 4 4 4 1 4 4 4 4 4 4 4 4 4 4 4 6 4 4 4 4 4 4 1
2 4 4 6 4 4 1 4 4 6 4 4 1 4 4 6 4 4 4 4 4 4 4 5 4 1
1 4 4 4 4 4 1 1 1 1 4 4 1 4 4 4 4 4 4 7 4 8 4 4 4 1
1 4 4 6 4 4 4 6 4 4 4 7 1 4 4 4 4 4 4 4 4 4 4 4 4 3
2 4 4 4 4 4 4 4 4 4 4 4 1 1 1 1 1 1 1 1 1 1 4 4 4 1
1 4 4 4 7 4 4 4 4 6 4 4 1 4 4 4 4 4 4 4 4 4 4 7 4 1
1 4 4 4 4 4 4 6 4 4 4 4 3 4 4 4 4 4 4 6 4 4 6 4 4 1
1 6 6 4 4 4 4 4 4 4 4 4 1 4 4 4 8 4 4 4 4 4 4 4 4 1
1 8 4 4 7 4 4 6 4 4 4 4 2 7 4 4 6 4 6 1 4 4 4 4 4 3
1 4 7 4 4 4 6 5 4 4 6 4 1 6 4 4 4 4 4 1 4 4 6 4 4 1
1 4 4 4 4 4 4 4 4 4 4 4 1 4 4 4 4 4 4 1 4 4 4 4 4 1
1 1 1 2 2 1 2 1 1 3 1 1 1 2 2 3 1 1 2 1 1 1 3 1 3 1